19 70
||||||||||||||||||||||||||||||||||||||||||||||||||||||||||||||||||||||
|*****|*|||******|***|**||*****|****||*******|****|**||*||****||****||
||*||*****|*|*||***|*||*****||***||***||||*|*|*|*||*|***||*||*||*||*||
|*||**|||***||***||**||*|*|*||*||||*||****|****|****|*|**|**|*******||
||***||*|||****|*|||*||***|**|*|*****|*||*|*||||*||*|*||*||*|||*|||*||
||*||||*|*|*|||**|***||*|*||*|*||*||*|*|**|***|***||***|****||***|||||
||**|***||****|*||*||***|*|**|**|*|****|*||||*|||****|*||*||||*|****||
|*|||*||**|||*|*|****|*|**|*||*||*||*|||*|||****||||||*|*****||||||*||
||**|*|||**|***|||*|*|*|*|**|*****|||*||*|***||*||***|||*|********|*||
||*|****|*|**|*||*||*|*|*|*|||*|||$|******|*|***||*|***|*|*|||*||*|**|
||*||||****|*|**|*||*||****||**|***||*|||*|*|*||||**||*|*|**|*|*|*||*|
||**|*||||*||||*|****||*||**|*|||*|*|**||**||*****|**|***|*|*|**|*||*|
|*|*|*|******||*|||*|||*||****|||*|**|**||*|*|||*|||*||||**||**||*|**|
|*|*|||*|||*|*|*||******|||*||****||***|||*******||**||***|***|***|*||
|*|***|**||*|||*||*|||||||*|***|||*|*||*|||**|||||**|***||**|*||*||**|
||*||*||*||******|*|****|****|*|***||*|****||*|||**||*||*|*||*||*|*|*|
||*||*||*|*|||*|||*|*||**|||*|||*|*|***|||******|*||**||***|*****||**|
|********||**|*****|***|*********|***|*****||||********||||*||||****||
||||||||||||||||||||||||||||||||||||||||||||||||||||||||||||||||||||||
