19 57
|||||||||||||||||||||||||||||||||||||||||||||||||||||||||
||***|*||*|||****||||||||||***||*||||||*****|||||||**|*$|
||*********|**||*||******||*||****|||||*|||*|||||***||*||							
|||||||*||*||*||*||*||||*||*|**||**||||*|||*|||||*|*||*||							
||****|*||*||*||*||*||||*||*||*|||*|||**|||**||||*|*||*||								
||*||*|*|*****|**||****|*|***|*|||*|||****||*||||*|**|**|  							
||**|||*|||||||*||||||*|*|||*|*|||***||||*||**||**||*||*|						
|||***********|*****||*|**||*|*|||||*|||**|||*||*|||**|*|							
|*|||||||||||*|||||*||*||*||******||*||||**||*||***||*|*|							
|*|******|*||*||****||**|*|||||||*||*|||||*||*||||*||*|*|							
|||*||||*|*||*||*||||||*|*******|*||*|||*|*||***||**|*|*|							
||**||||*||||*||*|||||**|||||||*|*||*|***|*||||*|||*|*|*|							
||*||||**|****||*||||**||****||*|*||*|||*****||***|*|*|*|							
||***||*||*|||||*||||*|||*||****|*||*|||||||**||*||*|*|*|							
||||*||*||*|*****||||*|||*|||||||*||*||||||||*||*||*|*|*|							
||||*||*||*|*||||||||*|||*********||*****||***||*||*|*|*|							
||||*||*||*|*||||||||*||||||||*|||||||||*||*||||*|**|***|							
|****||****|***************************|****||||***||||||							
|||||||||||||||||||||||||||||||||||||||||||||||||||||||||
