19 57
|||||||||||||||||||||||||||||||||||||||||||||||||||||||||
||**||*************|||||||||***********************||**$|
|****||*||||||||*|||||||***|*||||||*|||||||||||*|||||*|||							
|*||*|***|*******||*||||||*|*****||*||********||*||||*|||							
|*||*|||*|||||||*|*****|||*|||||*||*||*||||||*|||**||*|||								
|*||*||*****||||****|||*||*|||||*||*||*||*|||*||||*||*|||  							
|*||*||||||*||||||*||||*||*||||***||||*||*|||*|||**||*|||						
|*********|*||||*|*||||*||*||||*|**||**||**||*|||*|||*|||							
|||||*|||*|*|||**|*||||****||||*||*||*||||*||*|||*|||*|||							
|***|*|||*|*||||||*|||||*|*|||**||*||*||***||*|||*|||*|||							
|*|*|*|||*|*|||******|||||*|||*||**||*|||*|||*|||***|*|||							
|*|***||**|*||||||||*||*||*|||*|||*||*|||**||*||||||**|||							
|*|||****||*|||***|****|||*|||*|||*||*||||*||*|||****||||							
|*||||*||||*|||||||*||||||*|||*|||*||*||||*||*|||*|||||||							
|*||||*|||**||***|**||||||******||*||*||***||*****|||*|||							
|*||***|*|*||||||||*|||||||||||**|*||*||*||||*||||||**|||							
|*||*|||||*||||||||******|||||||*|||**|||****|||*****||||							
|*||*******||*|*|**|||||*************|||||||*****||||||||							
|||||||||||||||||||||||||||||||||||||||||||||||||||||||||
